0,0 1,0 2,0 3,0 4,0
0,1 1,1 2,1 3,1 4,1
0,2 1,2 2,2 3,2 4,2
0,3 1,3 2,3 3,3 4,3
0,4 1,4 2,4 3,4 4,4


1 1 1 1 1
1 1 1 1 1
1 1 1 0 0
0 0 0 0 0
0 0 0 0 0

0 1 0 0 0
1 1 1 1 1
0 1 1 1 0
0 0 1 1 0
0 0 1 1 1

0 0 0 0 0
1 1 0 0 0
1 1 1 0 0
0 1 1 1 1
1 1 1 1 1

   0 1 2 3 4 5 6 7 8 9
  -------------------
0 |0 0 0 0 0 1 1 1 1 0
1 |0 0 0 0 0 1 1 1 0 0
2 |0 0 0 0 1 1 0 1 1 0
3 |0 0 0 0 0 0 0 0 1 0
4 |0 0 0 0 0 0 0 0 0 0
5 |0 0 0 0 0 0 0 0 0 0
6 |0 0 0 0 0 0 0 0 0 0
7 |0 0 0 0 0 0 0 0 0 0
8 |0 0 0 0 0 0 0 0 0 0
9 |0 0 0 0 0 0 0 0 0 0

   0 1 2 3 4 5 6 7 8 9
  -------------------
0 |0 0 0 0 0 0 0 0 0 0
1 |0 0 0 0 0 0 0 0 0 0
2 |0 0 0 0 0 0 0 0 0 0
3 |0 0 0 0 0 0 0 0 0 0
4 |0 0 0 0 0 0 0 0 0 0
5 |0 1 0 0 0 0 0 0 0 0
6 |0 1 0 0 0 0 0 0 0 0
7 |0 1 1 1 1 0 0 0 0 0
8 |1 1 1 0 1 0 0 0 0 0
9 |1 1 0 0 0 0 0 0 0 0

   0 1 2 3 4 5 6 7 8 9
  -------------------
0 |0 0 0 x x 0 0 0 0 0
1 |0 0 0 x x x x 0 0 0
2 |0 0 0 x x x x 0 0 0
3 |0 0 0 x x x 0 0 0 0
4 |0 0 0 0 0 0 0 0 0 0
5 |0 0 0 0 0 0 0 0 0 0
6 |0 0 0 0 0 0 0 0 0 0
7 |0 0 0 0 0 0 0 0 0 0
8 |0 0 0 0 0 0 0 0 0 0
9 |0 0 0 0 0 0 0 0 0 0

   0 1 2 3 4 5 6 7 8 9
  -------------------
0 |0 0 0 0 0 0 0 0 0 0
1 |0 0 0 0 0 0 0 x 0 0
2 |0 0 x 0 0 0 x x 0 0
3 |0 0 x x 0 0 x x 0 0
4 |0 0 0 x x x x 0 0 0
5 |0 0 0 x x x 0 0 0 0
6 |0 0 0 0 0 0 0 0 0 0
7 |0 0 0 0 0 0 0 0 0 0
8 |0 0 0 0 0 0 0 0 0 0
9 |0 0 0 0 0 0 0 0 0 0

   0 1 2 3 4 5 6 7 8 9
  -------------------
0 |0 0 0 0 0 0 0 0 0 0
1 |0 0 0 0 0 0 0 0 0 0
2 |0 0 0 0 0 0 0 0 0 0
3 |0 0 x x x 0 0 0 0 0
4 |0 0 x x x x 0 0 0 0
5 |0 0 x x x x 0 0 0 0
6 |x x x 0 0 0 0 0 0 0
7 |0 0 0 0 0 0 0 0 0 0
8 |0 0 0 0 0 0 0 0 0 0
9 |0 0 0 0 0 0 0 0 0 0

   0 1 2 3 4 5 6 7 8 9
  -------------------
0 |0 0 0 0 0 0 0 0 0 0
1 |0 0 0 0 0 0 0 0 0 0
2 |0 0 0 0 0 0 0 0 0 0
3 |0 0 0 0 0 0 0 0 0 0
4 |0 0 0 0 0 0 0 0 0 0
5 |0 0 0 0 0 0 0 0 0 0
6 |0 0 0 0 0 0 0 0 0 0
7 |0 0 0 0 x x 0 0 0 0
8 |0 0 0 x x s x x 0 0
9 |0 0 0 x x x x x x 0

   0 1 2 3 4 5 6 7 8 9
  -------------------
0 |0 x x x x x x 0 0 0
1 |x x 0 0 x x s 0 0 0
2 |0 0 0 0 0 x 0 0 0 0
3 |0 0 0 0 0 0 0 0 0 0
4 |0 0 0 0 0 0 0 0 0 0
5 |0 0 0 0 0 0 0 0 0 0
6 |0 0 0 0 0 0 0 0 0 0
7 |0 0 0 0 0 0 0 0 0 0
8 |0 0 0 0 0 0 0 0 0 0
9 |0 0 0 0 0 0 0 0 0 0

   0 1 2 3 4 5 6 7 8 9
  -------------------
0 |0 0 0 0 0 0 0 0 0 0
1 |0 0 0 0 0 0 0 0 0 0
2 |0 0 0 0 0 0 0 0 0 0
3 |x 0 0 0 0 0 0 0 0 0
4 |x x 0 0 0 0 0 0 0 0
5 |x s x 0 0 0 0 0 0 0
6 |x x 0 0 0 0 0 0 0 0
7 |x x 0 0 0 0 0 0 0 0
8 |0 x 0 0 0 0 0 0 0 0
9 |0 x x x 0 0 0 0 0 0

   0 1 2 3 4 5 6 7 8 9
  -------------------
0 |0 0 0 0 0 0 0 0 0 0
1 |0 0 0 0 0 0 0 0 0 0
2 |0 0 0 0 0 0 0 0 0 0
3 |0 0 0 0 0 0 0 0 0 0
4 |0 0 0 0 0 0 0 0 0 x
5 |0 0 0 0 0 0 0 0 x x
6 |0 0 0 0 0 0 0 x x x
7 |0 0 0 0 0 0 0 x x 0
8 |0 0 0 0 0 x x x 0 0
9 |0 0 0 0 0 x s 0 0 0

   0 1 2 3 4 5 6 7 8 9
  -------------------
0 |0 0 0 0 0 0 0 0 0 0
1 |0 0 0 0 0 0 0 0 0 0
2 |0 0 0 0 0 0 0 0 0 0
3 |0 0 0 0 0 0 0 0 0 0
4 |0 0 0 x 0 0 0 0 0 0
5 |0 0 0 x 0 0 0 0 0 0
6 |0 0 0 x x 0 0 0 0 0
7 |0 0 x x 0 0 0 0 0 0
8 |0 0 x x x x 0 0 0 0
9 |0 0 0 x x s 0 0 0 0

   0 1 2 3 4 5 6 7 8 9
  -------------------
0 |0 0 0 0 0 0 0 0 0 0
1 |0 0 0 0 0 0 0 0 0 0
2 |0 0 0 0 0 0 0 0 0 0
3 |0 0 0 0 0 0 0 0 0 0
4 |0 0 0 x 0 0 0 0 0 0
5 |x x x x 0 0 0 0 0 0
6 |x x x x x 0 0 0 0 0
7 |0 0 0 s x 0 0 0 0 0
8 |0 0 0 0 0 0 0 0 0 0
9 |0 0 0 0 0 0 0 0 0 0

   0 1 2 3 4 5 6 7 8 9
  -------------------
0 |0 0 0 0 0 0 0 0 0 0
1 |0 0 0 0 0 0 0 0 0 0
2 |0 0 0 0 0 0 0 0 0 0
3 |0 0 0 0 0 0 0 0 0 0
4 |0 0 0 0 0 0 0 0 0 0
5 |0 0 0 0 x x x 0 0 0
6 |0 0 0 0 0 x x 0 0 0
7 |0 0 0 0 0 0 x 0 0 0
8 |0 0 0 0 0 s x 0 0 0
9 |0 0 0 0 0 x x x x x


